{
  "黃": "黄",
  "參": "参",
  "異": "异",
  "體": "体",
  "當": "当",
  "歸": "归",
  "龍": "龙",
  "蘭": "兰",
  "實": "实",
  "證": "证",
  "醫": "医",
  "藥": "药",
  "處": "处",
  "復": "复",
  "複": "复",
  "製": "制",
  "術": "术",
  "鬱": "郁",
  "鬱金": "郁金",
  "薑": "姜",
  "薑黃": "姜黄",
  "葉": "叶",
  "莖": "茎",
  "經": "经",
  "脈": "脉",
  "絡": "络",
  "腫": "肿",
  "潰": "溃",
  "瘍": "疡",
  "癒": "愈",
  "發": "发",
  "熱": "热",
  "溼": "湿",
  "溫": "温",
  "涼": "凉",
  "陰": "阴",
  "陽": "阳",
  "虛": "虚",
  "補": "补",
  "瀉": "泻",
  "氣": "气",
  "血": "血",
  "風": "风",
  "寒": "寒",
  "暑": "暑",
  "燥": "燥",
  "火": "火",
  "癀": "黄",
  "鮑": "鲍",
  "龜": "龟",
  "鼈": "鳖",
  "鑒": "鉴",
  "鑑": "鉴",
  "臟": "脏",
  "腸": "肠",
  "膚": "肤",
  "腦": "脑",
  "腎": "肾",
  "膽": "胆",
  "脾": "脾",
  "肺": "肺",
  "肝": "肝"
}
